{
    "version": "1.0",
    "data": {
        "kickArray": [
            1,0,0,0,0,1,0,0,0,0,1,0,0,0,0,0,
            0,0,0,0,0,0,0,0,0,0,0,0,0,0,0,0,
            0,0,0,0,0,0,0,0,0,0,0,0,0,0,0,0,
            0,0,0,0,0,0,0,0,0,0,0,0,0,0,0,0
        ],
        "snareArray": [
            0,0,0,0,1,0,0,0,0,0,0,0,1,0,0,0,
            0,0,0,0,0,0,0,0,0,0,0,0,0,0,0,0,
            0,0,0,0,0,0,0,0,0,0,0,0,0,0,0,0,
            0,0,0,0,0,0,0,0,0,0,0,0,0,0,0,0
        ],
        "hatArray": [
            1,0,1,0,1,0,1,0,0,0,1,0,0,0,0,0,
            0,0,0,0,0,0,0,0,0,0,0,0,0,0,0,0,
            0,0,0,0,0,0,0,0,0,0,0,0,0,0,0,0,
            0,0,0,0,0,0,0,0,0,0,0,0,0,0,0,0
        ],
        "star": {
            "bpm": 120,
            "beatsPerBar":7,
            "subBeatsPerBeat": 2
        },
        "chords": [
            {
                "name": "M7",
                "note": 55
            },
            {
                "name": "M",
                "note": 57
            },
            {
                "name": "m",
                "note": 59
            },
            {
                "name": "M",
                "note": 55
            }
        ],
        "notes": [
            57,59,61,62,64,66,67
        ],
        "melody": [
            0,0,0,0,0,0,66,67,66,0,64,0,0,0,
            66,0,0,0,64,0,62,0,0,0,62,0,64,0,
            66,0,0,0,0,0,66,67,66,0,61,0,0,0,
            59,0,0,0,57,0,57,0,0,0,59,0,59,0,
            0,0,0,0,0,0,0,0
        ]
    }
}
